111111
100101
1P0001
1CE101
111111