111111
100101
1P1001
1CE101
111111