111111
100C01
10P001
10FE01
111111