111111111111111111111111111111111
100100000C00000000010000001100001
1P0000C00000C0000C0000C0000000001
1CE100000000000011C10000100000001
100000C00000C0000C0000C0000000001
100000C00000C0000C0000C0000000001
100000C00000C0000C0000C0000000001
100000C00000C0000C0000C0000000001
111111111111111111111111111111111